#################
#  --   X   -   #
#    ---##  #   #
#  --    -  #---#
#   -   O       #
#   --   -      #
#   --    --    #
#  -        -   #
#################